NO textures/game/wall_north.xpm
SO textures/game/wall_south.xpm
WE textures/game/wall_west.xpm
EA textures/game/wall_east.xpm

E1 textures/game/enemies.xpm
E2 textures/game/enemy2.xpm

ED1 textures/game/enemy_dead1.xpm
ED2 textures/game/enemy_dead2.xpm

D textures/game/door.xpm

F 236, 211, 159
C 85, 90, 130

111111111111111111111111111111111
1111111110X00000001100000000000X1
111111111011000001110000000000001
111111111X01000000000000000000001
11111111101100000111X000000000001
1000X0000011000001110111110111111
11110111111111011100X00X100X11111
1111D1111111110111010100100011111
1100000X1101010111000000DX0011111
100000000000000011000000100011111
1000000X0000000011010100100011111
11000001110101011111X11110N011111
111101111111010111011110100011111
111111111111111111111111111111111
