NO textures/game/wall_north.xpm
SO textures/game/wall_south.xpm
WE textures/game/wall_west.xpm
EA textures/game/wall_east.xpm

E1 textures/game/enemies.xpm
E2 textures/game/enemy2.xpm

ED1 textures/game/enemy_dead1.xpm
ED2 textures/game/enemy_dead2.xpm

D textures/game/door.xpm

F 236, 211, 159
C 85, 90, 130

111111111111111111111111111111111
111111111000000000110000000000001
111111111011000001110000000000001
111111111001000000000000000000001
111111111011000001110000000000001
100000000011000001110111110111111
111101111111110111000000100X11111
1111D1111111110111010100100011111
1100000X1101010111000000D00011111
100000000000000011000000100011111
1000000X0000000011010100100011111
11000001110101011111011110N011111
111101111111010111011110100011111
111111111111111111111111111111111
