NO textures/game/wall_north.xpm
SO textures/game/wall_south.xpm
WE textures/game/wall_west.xpm
EA textures/game/wall_east.xpm

F 236, 211, 159
C 85, 90, 130

111111111111111111111111111111111
111111111000000000110000000000001
111111111011000001110000000000001
111111111001000000000000000000001
111111111011000001110000000000001
100000000011000001110111110111111
111101111111110111000000100011111
111101111111110111010100100011111
110000001101010111000000000011111
100000000000000011000000100011111
100000000000000011010100100011111
11000001110101011111011110S011111
111101111111010111011110100011111
111111111111111111111111111111111
